.#........##...........#......#...#.....#.#..#...#...##........#...##....#.#...#..##....##..#..#
.#.#.#......#....#.##.#...##.##...###....##......##...#.....#.#.....##..##....#.......#.........
#........#..#.#...#...#...#.#.#....#.##.....##.##...#......#...........#.#..#...#.#....#.#.....#
............#.......#.###.#.##.............##..#...#..........#.....#....##.#...#...###....#...#
....###..#.#..#...#...#...#.#..#..##.......##........#.......#.........#.....#.#....####........
...#.........#.#.....##......##.##..#.....#......#.#.#.#...#.....#......#.#...........###..#....
...#......##...##...........##.#..#.#..#..#............#.#......#.##.#.....#.......#....##......
.##.#..#..#.#..#.#.#....#..#.#.#.............#........#..#.#.##..........##........#..#....#....
..#..#....#..###.....#...#............#...#.#......#.......#...#.#...##....#.#.#.....#.###......
#............#..#.....#...###.##...#.##......#.#...#.....##....#..#.#..................#.##.....
...#.....#.....#....####..####.......#.#.###.#.......##....#.........#.##.......#....#...##..##.
#.........#...#.#....#..##..#.......................#...#....#.....#....#..#.#.##...#..#...#..#.
.####....##....##...#..#...#..#......#..#........#.#.....#...........#.......#..#..#..#.........
...#....#..#...#.#.....#....#.#.....###..#.#.#...#.......##........#.#...#...................#..
.#..#.#.#.....#....#.#..#.#.##.#..#..##.##........#...#.......#..#........#.....#....#...#...#..
#......##....##.....###....##..#.##.###..##...#....#.................#.......#.#....#.......#..#
............#..#....###.....#......##.....#...##......##.##.#....#.##...#.#.##........#..#..#...
...........#..#....#.#......#....#....##.#......#.#.....#.#..#.#...#.#......#...#....#......#...
#..#..........##.#.#....##.#.###....#..#.#..#....#.##.....##.......#....#..#.......#........###.
........#....#.#.....#...##......#...#.##...#....##....#.#.#....##..##.......#....#.#...#...#.#.
..#......#..###......##...#.#.#....#.#.#...........#.#..##.......#...#..#..#.#.#....#......#.#..
.#...................##...##..#.#...#...#.#..........#.....#.#......................##.##......#
.###....#.##.#.##...#.#.#...#..#..............###.#.##....#...##........#...#.......#....#....#.
.#..#....#.#..#.........#..####.#..........#....#.#.##..##..##.##..#...#........#..#..#...##....
..#.......#....#.......#...#.#..#.#.#.#.####......#.###........##........###....#...........###.
.#.##..........#.....................#.#####....#.#..###..#...#..#.#.##..........#.........###.#
.##.....#......#.....#....#...#.....##..#....#...####..#...#..##.#..#....#...#....###.....##....
...#...#........#.#..#.#..###...###.#...#....#.....#....#...#...##..................###...#....#
..#......#.#..#.........##..#.....#.##...#.#.......#.....##...##.#.#..............#.#...........
#.#...#.#..####.####...#.#......##.....#..#..#....#.#........#.#....#.##.##.#....###..#....#....
.....##.....#..#..#....#...#..#....##.#.#............#...#.##.###...........#...........#.###.#.
#...#..#...#.........##.#.####..#..###.#..#....#..#.###..##...#..#....#...#...#...#........###..
#....#..##..#..#...........#..#.#.#.........#....#..#....##.#.........#............##.....###..#
..###...##.#...#.#......#...........##..............#...##...#..........#.....###.#.#.#.#...##..
.####.....##.......#...#.#.#.#.##..#...#..#.#.....#.#..##.....#.#.#.#.....#.........##..........
...#...#......#...#.....#.##.#.##..#.....###........##.##.....#####.........#.#....#.#.....#....
#..........#..#..##..#........###..###.....#....#....#.........#...#...#......#.#.......#.###...
.....#...#..#...#...#.#.......#.#...###..............#.##.#..##.....#....#.#...#.#.....#........
...##..##.#....###....#........##........#...###....#.##.###...#.......#..#..#....##.#..........
.#.#....#.#.............#....#.#...#.....#.#..#..#.#.....#..#..........#..######....##....#.#.#.
...#...##.###...#...#..#...#.###....#...#.........#.....#.....#..#.......##..#.....###........#.
...##.#...##...##.###....#.....##..........#.....#.##......#...#...##.#..........##........##...
...#.....#.#.###.#.#...#...#...#....#..........#...#.#..........#....##.#.##.....#..#.....#...#.
.###.....##..#....#...#...##.##.....##......#...#..#..#.#.##.....#..#..#...........##.....#.....
......#...#..#.#......#..#.##..#.#.#....#.....#..#.......#....#.#.#..#......#.##..#..#.#....#...
...#....##...#..........#.....#..........###..........#..##...#.#....#..#........#.....#....##..
..#.....#.#...##.#.......#....#...#........#..#....#.#..#.........#.......#.#........#..#..##...
.#..##....##.##....#.#.#.......##.#.#..#..#.....#.#.#.#.#....##.#..##.##...#.#.....#..##...#..#.
.#.#.....##...#.....#......#...###..#........#.....#........#.....#...#.#..#.#..#.....#.#.....#.
......#.....#..#......#.##...##.....#..##...##.#..#..#..#.#.....#....#......#.##.#...#.#.#..#.#.
..........###.....#...#...#.#....#.#.....#......#..#...#.#...##...#.....#.#.........##.....#..#.
#..#.....#..#..###.#..####.........##....###...##...#............#.......#......#.#.#..##.#.#...
.#........#.....#...###.......#..##........##....#..##..#........#..#......###.##...........#.#.
..........##.#...#...##.#.....###.......#.....#..#......##.##.........#......###.......#...##...
.......#.#.#.#.......#..#.........#.###.......#.#..##.#..#....#........##.##..##.#...#...##.#.##
#..........#........#.##.##.###.....#...###..#.....##...#...#..........#.#.##.....##..#.#..###.#
.......#..........#......#....#..#.#..#..##..#.###.#...#..#.....#...#....#.#.........#...#.#...#
.#.......#..##.......#.#..#.##..#.#.....#..#......##.....#.#..............##......#.#......##...
.....#....#...#.....#..........##.#.#.....#.#.....#..#.....#....##.#......#.#..#..##.....#..#.##
.......#..........#..##.#.##.#..##.#.##.#...#..#.....#..##.....#..#.#..#...#..#...#.#..#.###....
.#.#..###.#.......#..#..#.#...........#.#...#.##..#.....##.##...#.......###...#.#.#....#..#.##..
.......##...#....#.##..........#..#.##...#...#..#..#....#.#.......#...#..#.###.........#..#.##..
#.#..#...#........#.....#...#......#........#......#...#..........#.##...#.##...#..#.###.####...
.....#.#.#....#...#...#...#...###...#.........#...##.........#..#..#.#..###.#.#.#.#..##.##..##.#
##.#....#.......#...#..........#.....##......#.........#.....#.....##.#......#.#....###.#......#
........#..#..#.#...##....#..#...#..#..##.............##..#.......##.#.#......................#.
..#.##.....##........#.#.#.#...##.#.##.....#......##....#.....###.#.......##.#.......##.....#.#.
..#........#...#.##.#.#..#...#....#.#....#......#..#....##..#.##...#.....#.##.##..#....#..#...#.
.#........#.....................#..###.#.....#.....###.#.......#..#..#.....##.....##...####.#...
....#....#.....##.............#.#......#...#..#...##......#.##.##.#...#..###...#.#..........##..
.#.....#..##.#..##.##.#.......#...#.#.#............#.....##.#..#...#..##.......#.##....#..#.##..
##.......##..#.....#.#.....#..##...#.........##..###...#......#....##.........#..#....#...###...
....#.....##............#..#...#.#..#........#....#.....#.........#.#.....##.##.##.#..###.#.....
........#..#.#........#..#..........#..#..#.#..#...#.#..#..#.....##........###.......####.....#.
.....#....####....#..###.#....#....#..#.#..#.##...#....#.............##..#.........#.#...#.#..##
#........#.....#......#.........#..#......##...#.#.###.#...#......#.......#...#.#..#.......##..#
.....#......#...#......#...............#.........#.#.......#.###.#.###.....##....#.##.###..##.#.
......#.#.#...#...#........##..##..#.....#.#...#.#.#..###....#.###.#.............##.##.#...#....
.......#..##..#..#....#......#...#.##..#........#...#...#..#..#..##..#..##...#..#...#.#..#...##.
.#..#.####.#...#....#...#...#.......#...........##..#.#.#.#..#....##..#.#.###......#..#........#
..#....##.#..#....#........#.......#..#.....#.##.................#.....#...###..#...##.....###.#
###......#...##.......#.###..##...............#..##.#.....#.......#....#......#.#..#...##...#.#.
..#.#..#.....##...#...#.#.##.#........##...#...##.#...#....#......##.....#.....#.##....#....#...
..###.....#....##..................#....#........#........#.....##.....##...##.#.#...#..##.#..#.
.##.....#####..#...#...#.##..#.#...##.......#.#.........##.....#####..##.......##....##..#.#....
#....##.#.....#....#.........#.....#........##...............##..#...#..#..........####..#......
.......#...#.......#......#..###..#.#.##..#...#....#...#.##..........#....#.#..#.....#.....#...#
.#.#.#.#..#....#..#.#.#...##.#....#.#....#..........#...#.................#.#.#.#...#.##...###..
......#.#.#...........#.....#.#..##.....#...#...#..#..#.##.....................#.#..##......#..#
.........#............#..#.....#...##.##...#......#.#.#...#..#...#..#.....####.......#...#......
......##..####...#.....#..##......#.......##..##......#...#...###..#..#......#.......##.........
...##.#..#...#..#..........#..##..#.....#......#......#...#....#.........#...#.#..#....##..#..#.
.#....#....##.....#.#..#....#.##..##.#..#....##..###.........#.#.#..###.#..#..........#.###..#..
.#.#..#.#........#..#.....#.#.....#....#..##....#............#..............##...#..#..#.#.....#
..........#.#...##....#......##....#.#.###...#......#...............#.......##........#....#.#..
##.#...........#.....#.....##.#...#.##.##....#.....#.......#.#.....#..#..#....#.#.....#....#.#.#
